10,10
0000010001
0101010100
0101000101
1000111000
0010000110
1100101001
0001001101
0100110000
0011000101
1000011000